⠀⠀⠀⠀⠀⠀⠀⠀⠀⠀⠀⠀⠀⠀⠀⠀⠀⠀⠀⠀⠀⣄⠀⠀⠀⠀⠀⠀
⠀⠀⠀⠀⠀⠀⠀⠀⠀⠀⢀⣀⣤⣤⣄⠀⠀⠀⠀⠀⠀⣿⣆⠀⠀⠀⠀⠀
⠀⠀⠀⠀⠀⢀⣴⣿⣿⣿⣿⣿⣿⣿⣿⣿⣤⠀⠀⠀⠀⣿⣿⡄⠀⠀⠀⠀
⠀⠀⠀⠀⣠⡿⠿⠻⢿⣿⣿⣿⣿⣿⣿⣿⡇⠀⠀⠀⠀⢹⣿⡇⠀⠀⠀⠀
⠀⠀⠀⠀⣀⣤⣶⡀⠀⠻⢛⣿⣿⣿⣿⣿⡇⠀⠀⠀⠀⠈⣿⣷⠀⠀⠀⠀
⠀⠀⢠⣾⣿⣿⣿⣿⡦⣼⣯⣵⣿⣿⣿⣿⣷⣦⡀⠀⠀⠀⢹⣿⠀⠀⠀⠀
⠀⢠⣿⣿⣿⣿⣿⣿⡿⠿⢿⣿⣿⣿⣿⣿⡿⣿⣿⣦⣀⢀⡘⣿⡇⠀⠀⠀
⠀⣾⣿⣿⣿⣿⡟⠉⠀⠀⣾⣿⣿⣿⣿⠟⠁⠀⠉⠻⣿⣿⣿⣿⣧⣠⣶⠄
⢰⣿⣿⣿⡿⠋⠀⠀⠀⢀⣿⣿⣿⣿⣿⡀⠀⠀⠀⠀⠙⠻⣿⣿⣿⡟⠁⠀
⢸⣿⡿⠋⠀⠀⠀⠀⢠⣿⣿⣿⣿⣿⣿⣿⣄⠀⠀⠀⠀⠀⠀⠙⢻⡃⠀⠀
⠀⠁⠀⠀⠀⠀⠀⠀⣾⣿⣿⠿⣿⡿⢿⣿⣿⣆⠀⠀⠀⠀⠀⠀⠘⠃⠀⠀
⠀⠀⠀⠀⠀⠀⠀⢸⣿⣿⡇⠀⠀⠀⠀⠙⢿⣿⣶⣶⣤⠀⠀⠀⠀⠀⠀⠀
⠀⠀⠀⠀⠀⠀⠀⢻⣿⣿⡟⠀⠀⠀⠀⠀⠀⢸⣿⣿⣿⣧⠀⠀⠀⠀⠀⠀
⠀⠀⠀⠀⠀⠀⠀⠀⣻⣿⣿⠀⠀⠀⠀⠀⠀⠀⠉⢻⣿⣿⣇⠀⠀⠀⠀⠀
⠀⠀⠀⠀⠀⠀⢰⣾⣿⣿⠏⠀⠀⠀⠀⠀⠀⠀⠀⠀⢿⣿⣿⣦⠀⠀⠀⠀
⠀⠀⠀⠀⠀⠀⠈⠉⠉⠁⠀⠀⠀⠀⠀⠀⠀⠀⠀⠀⠘⠿⠿⠿⠀⠀⠀⠀

its dangerous to go it alone take this ` =